GGGGGGGGGGGGGGGGGGGGGGGGGGGGGGGGGGGGGGGGGGGGGGGGGGGGGGGGGGG
GGGGGGGGGGGGGGGGGGGGGGGGGGGGGGGGGGGGGGGGGGGGGGGGGGGGGGGGGGG
GGGGGGGGGGGGGGGGGGGGGGGGGGGGGGGGGGGGGGGGGGGGGGGGGGGGGGGGGGG
YYYYYYYYYYYYYYYYYYYYYYYYYYYYYYYYYYYYYYYYYYYYGGGGGGGGGGGGGGG
PYYYYYYYDYYYYYYYYYYYYYYYYYYYYYYYYYYYYYYYYYDYGGGGGGGGGGGGGGG
YYYYYYYYYYYYYYYYYYYYYYYYYYYYYYYYYYYYYYYYYYYYGGGGGGGGGGGGGGG
GGGYYYGWWDWWGGGGGGGGGGGGGGGGGGGGGGGGGGGGGYYYGGGGGGGGGGGGGGG
GGGYYYGWWWWWGGGGGGGGGGGGGGGGGGGGGGGGGGGGGYYYGGGGGGGGGGGGGGG
GGGYYYGWWWWWGGGGGGGGGGGGGGGGGGGGGGGGGGGGGYYYGGGGGGGGGGGGGGG
GGGYYYGGGGGGGGGGGGGGGGGGGGGGGGGGGGGGGGGGGYYYGGGGGGGGGGGGGGG
GGGYYYGGGGDGGGGGGGGGGGGGGGGGGGGGGGGGGGGGGYYYGGGGGGGGGGGGGGG
GGGYYYGGGGGGGGGGGGGGGGGGGGGGGGGGGGGGGWWWWYYYGGGGGGGGGGGGGGG
GGGYYYGGGGGGGGGGGGGGGGGGGGGGGGGGGGGGGWWWDYYYGGGGGGGGGGGGGGG
GGGYYYGGGGGGGGGGGGGGGGGGGGGGGGGGGGGGGWWWWYYYGGGGGGGGGGGGGGG
GGGYYYYYYYYYYYYYYYYYYYYYYYYYYYYYYYYYYYYYYYYYGGGGGGGGGGGGGGG
GGGYYYYYYYYYYYYYYYYYYYYDYYYYYYYYYYYYYYYYYYYYGGGGGGGGGGGGGGG
GGGYYYYYYYYYYYYYYYYYYYYYYYYYYYYYYYYYYYYYYYYYGGGGGGGGGGGGGGG
GGGGGGGGGGGGGGGGGGGGGGGGGGGGGGGGGGGGGGGGGYDYGGGGGGGGGGGGGGG
WDWGGGGGGGGGGGGGGGGGGGGGGGGGGGGGGGGGGGGGGYYYGGGGGGGGGGGGGGG
WWWGGGGGGGGGGGGGGGGGGGGGGGGGGGGGGGGGGGGGGYPYGGGGGGGGGGGGGGG