GGGGGGGGGGGGGGGGGGGGGGGGGGGGGGGGGGGGGGGGGGGGGGGGGGGGGGGGGGG
GGGGGGGGGGGGGGGGGGGGGGGGGGGGGGGGGGGGGGGGGGGGGGGGGGGGGGGGGGG
GGGGGGGGGGGGGGGGGGGGGGGGGGGGGGGGGGGGGGGGGGGGGGGGGGGGGGGGGGG
GGGYYYYYYYYYYYYYYYYYYYYYYYYYYYYYYYYYYYYYYYYYYYYYYYYYYYYYYYY
GGGYDYYYYYYYYYYYYYYYYYYYYYYYYYYYYYYYYYYYYYYYYYDYYYYYYYYYYYP
GGGYYYYYYYYYYYYYYYYYYYYYYYYYYYYYYYYYYYYYYYYYYYYYYYYYYYYYYYY
GGGYYYGGGGGGGGGGGGGGGGGGGGGGGGGGGGGGGGGGGYYYGGGGGGGGGGGGGGG
GGGYYYGGGGGGGGGGGGGGGGGGGGGGGGGGGGGGGGGGGYYYGGGGGGGGGGGGGGG
GGGYYYGGGGGGGGGGGGGGGGGGGGGGGGGGGGGGGGGGGYYYGGGDGGGGGGGGGGG
GGGYYYGGGGGGGGGGGGGGGGGGGGGGGGGGGGGGGGGGGYYYYYYYYYYYYWWWGGG
GGGYYYGGGGGGGGGGGGGGGGGGGGGGGGGGGGGGGGGGGYYYYYYYYYYYYDWWGGG
GGGYYYGGGGGGGGGGGWWWWWGGGGGGGGGGGGGGGGGGGYYYYYYYYYYYYWWWGGG
GGGYYYGGGGGGGGGGGWWWWWGGGGGGGGGGGGGGGGGGGYYYGGGGGGGGGGGGGGG
GGGYYYGGGGGGGGGGGWWDWWGGGGGGGGGGGGGGGGGGGYYYGGGGGGGGGGGGGGG
GGGYYYYYYYYYYYYYYYYYYYYYYYYYYYYYYYYYYYYYYYYYGGGGGGGGGGGGGGG
GGGYDYYYYYYYYYYYYYYYYYYYYYYYYYYYYYYYYYYYYYYYGGGGGGGGGGGGGGG
GGGYYYYYYYYYYYYYYYYYYYYYYYYYYYYYYYYYYYYYYYYYGGGGGGGGGGGGGGG
GGGYYYGGGGGGGGGGGGGGGGGGGGGGGGGGGGGGGGGGWDWGGGGGGGGGGGGGGGW
GGGYYYGGGGGGGGGGGGGGGGGGGGGGGGGGGGGGGGGGWWWGGGGGGGGGGGGDGGG
GGGYYYGGGGGGGGGGGGGGGGGGGGGGGGGGGGGGGGGGWWWGGGGGGGGGGGGGGGW